1111111111111
10C10000000C1
1P00011111001
100X11E0000C1
1111111111111
