1111111111111
10010000C0001
1P00011111001
100011E000001
1111111111111
