1111111111
10010010E1
101C101001
1001001101
1P00000001
1111111111
